{
  "niveles": [
    {
      "nombre": "Nivel 1",
      "laberinto": [
        [1,1,1,1,1,1,1,1,1,1,1,1,1,1,1,1,1,1],
        [1,0,0,0,0,0,0,1,0,0,0,1,0,0,0,0,0,1],
        [1,0,1,1,1,0,0,1,0,1,0,1,0,1,1,1,0,1],
        [1,0,1,0,0,0,1,1,0,1,0,1,0,0,0,1,0,1],
        [1,0,1,0,1,0,0,0,0,1,0,1,1,1,0,1,0,1],
        [1,0,0,0,1,1,1,1,0,0,0,0,0,1,0,0,0,1],
        [1,1,1,0,0,0,0,1,1,1,1,1,0,1,0,1,0,1],
        [1,0,0,0,1,1,0,0,0,0,0,1,0,0,0,1,0,1],
        [1,0,1,0,0,1,0,1,1,1,0,1,0,1,0,1,0,1],
        [1,0,1,1,0,1,0,0,0,1,0,1,0,1,0,0,0,1],
        [1,0,0,1,0,0,0,1,0,1,0,1,0,1,1,1,0,1],
        [1,1,0,1,1,1,0,1,0,1,0,0,0,1,0,0,0,1],
        [1,0,0,0,0,1,0,1,0,1,1,1,0,1,0,1,1,1],
        [1,0,1,1,0,1,0,0,0,0,0,1,0,1,0,0,0,1],
        [1,0,1,0,0,1,1,1,1,1,0,1,0,1,1,1,0,1],
        [1,0,1,0,1,1,0,0,0,1,0,0,0,1,0,1,0,1],
        [1,0,0,0,0,0,0,1,0,1,0,1,0,0,0,1,0,1],
        [1,1,1,1,1,1,1,1,1,1,1,1,1,1,1,1,1,1]
      ],
      "entrada": [1,1],
      "salida": [16,16],
      "vel_enemigos": 14,
      "enemigos": 2,
      "powerups": 1,
      "colores": {"pared": [80,80,80], "suelo": [220,230,245], "enemigo": [220,50,50]}
    }
  ]
}
