{
  "niveles": [
    {
      "laberinto": [
        [1,1,1,1,1,1,1,1,1,1,1,1,1,1,1],
        [1,0,0,0,0,0,0,0,0,0,0,0,0,0,1],
        [1,0,1,1,0,1,1,1,1,1,1,1,0,0,1],
        [1,0,0,0,0,0,0,0,0,0,0,0,0,0,1],
        [1,1,1,1,1,1,1,1,1,1,1,1,1,1,1]
      ],
      "vel_enemigos": 10,
      "estrellas": 3,
      "enemigos": 2,
      "powerups": 2
    },
    {
      "laberinto": [
        [1,1,1,1,1,1,1,1,1,1,1,1,1,1,1],
        [1,0,1,0,0,0,1,0,0,0,1,0,0,0,1],
        [1,0,1,0,1,0,1,0,1,0,1,0,1,0,1],
        [1,0,0,0,1,0,0,0,1,0,0,0,1,0,1],
        [1,1,1,1,1,1,1,1,1,1,1,1,1,1,1]
      ],
      "vel_enemigos": 8,
      "estrellas": 4,
      "enemigos": 3,
      "powerups": 2
    }
  ]
}