{
  "niveles": [
    {
      "nombre": "Tutorial Basico",
      "laberinto": [
        [1,1,1,1,1,1,1,1,1,1,1,1,1,1,1,1,1,1,1,1],
        [1,2,0,0,0,0,0,0,0,0,0,0,0,0,0,0,0,3,0,1],
        [1,0,1,1,0,1,1,1,0,1,1,0,1,1,1,0,1,1,0,1],
        [1,0,1,1,0,1,1,1,0,0,0,0,1,1,1,0,1,1,0,1],
        [1,0,0,0,0,0,0,0,0,1,1,0,0,0,0,0,0,0,0,1],
        [1,0,1,1,0,1,0,1,1,1,1,1,1,0,1,0,1,1,0,1],
        [1,0,0,0,0,1,0,0,0,1,1,0,0,0,1,0,0,0,0,1],
        [1,1,1,1,0,1,1,1,0,0,0,0,1,1,1,0,1,1,1,1],
        [1,0,0,1,0,1,0,0,0,0,0,0,0,0,1,0,1,0,0,1],
        [1,1,1,1,0,1,0,1,1,1,1,1,1,0,1,0,1,1,1,1],
        [1,0,0,0,0,0,0,0,0,1,1,0,0,0,0,0,0,0,0,1],
        [1,0,1,1,0,1,1,1,0,0,0,0,1,1,1,0,1,1,0,1],
        [1,0,0,1,0,0,0,0,0,1,1,0,0,0,0,0,1,0,0,1],
        [1,0,0,0,0,1,1,1,0,1,1,0,1,1,1,0,0,0,0,1],
        [1,1,1,1,1,1,1,1,1,1,1,1,1,1,1,1,1,1,1,1]
      ],
      "vel_enemigos": 18,
      "estrellas": 4,
      "enemigos": 2,
      "powerups": 1,
      "entrada": [1,1],
      "salida": [18,1],
      "colores": {"pared": [60,60,60], "suelo": [220,220,220], "enemigo": [220,50,50]}
    },
    {
      "nombre": "Nivel Intermedio",
      "laberinto": [
        [1,1,1,1,1,1,1,1,1,1,1,1,1,1,1,1,1,1,1,1],
        [1,2,0,0,0,0,0,0,0,0,0,0,0,0,0,0,0,3,0,1],
        [1,0,1,1,1,0,1,1,0,1,1,0,1,1,0,1,1,1,0,1],
        [1,0,1,1,1,0,1,1,0,1,1,0,1,1,0,1,1,1,0,1],
        [1,0,0,0,0,0,0,0,0,0,0,0,0,0,0,0,0,0,0,1],
        [1,0,1,1,0,1,1,1,1,1,1,1,1,1,1,0,1,1,0,1],
        [1,0,0,0,0,0,0,0,0,1,1,0,0,0,0,0,0,0,0,1],
        [1,1,1,0,1,1,1,1,0,1,1,0,1,1,1,1,0,1,1,1],
        [1,0,0,0,1,0,0,0,0,0,0,0,0,0,1,0,0,0,0,1],
        [1,1,1,0,1,0,1,1,1,1,1,1,1,0,1,0,1,1,1,1],
        [1,0,0,0,0,0,0,0,0,1,1,0,0,0,0,0,0,0,0,1],
        [1,0,1,1,1,1,1,1,0,0,0,0,1,1,1,1,1,1,0,1],
        [1,0,0,0,0,0,0,0,0,1,1,0,0,0,0,0,0,0,0,1],
        [1,0,1,1,0,1,1,1,0,1,1,0,1,1,1,0,1,1,0,1],
        [1,1,1,1,1,1,1,1,1,1,1,1,1,1,1,1,1,1,1,1]
      ],
      "vel_enemigos": 16,
      "estrellas": 4,
      "enemigos": 2,
      "powerups": 1,
      "entrada": [1,1],
      "salida": [18,1],
      "colores": {"pared": [80,80,80], "suelo": [210,230,245], "enemigo": [220,50,50]}
    },
    {
      "nombre": "Nivel Avanzado",
      "laberinto": [
        [1,1,1,1,1,1,1,1,1,1,1,1,1,1,1,1,1,1,1,1],
        [1,2,0,0,0,1,0,0,0,0,0,0,0,0,1,0,0,3,0,1],
        [1,0,1,1,0,1,0,1,1,1,1,1,1,0,1,0,1,1,0,1],
        [1,0,0,0,0,0,0,0,0,1,1,0,0,0,0,0,0,0,0,1],
        [1,0,1,1,1,1,1,1,0,1,1,0,1,1,1,1,1,1,0,1],
        [1,0,0,0,0,0,0,0,0,0,0,0,0,0,0,0,0,0,0,1],
        [1,1,1,0,1,0,1,1,1,1,1,1,1,1,0,1,0,1,1,1],
        [1,0,0,0,1,0,0,0,0,1,1,0,0,0,0,1,0,0,0,1],
        [1,0,1,0,0,0,1,1,0,0,0,0,1,1,0,0,0,1,0,1],
        [1,0,0,0,1,0,1,1,1,1,1,1,1,1,0,1,0,0,0,1],
        [1,0,1,1,1,0,0,0,0,1,1,0,0,0,0,1,1,1,0,1],
        [1,0,0,0,0,0,1,1,0,0,0,0,1,1,0,0,0,0,0,1],
        [1,0,1,1,1,0,1,1,1,1,1,1,1,1,0,1,1,1,0,1],
        [1,0,0,0,0,0,0,0,0,0,0,0,0,0,0,0,0,0,0,1],
        [1,1,1,1,1,1,1,1,1,1,1,1,1,1,1,1,1,1,1,1]
      ],
      "vel_enemigos": 14,
      "estrellas": 5,
      "enemigos": 3,
      "powerups": 2,
      "entrada": [1,1],
      "salida": [18,1],
      "colores": {"pared": [255,255,255], "suelo": [180,40,40], "enemigo": [40,40,220]}
    }
  ]
}
