{
  "niveles": [
    {
      "nombre": "Tutorial Basico",
      "laberinto": [
    [1,1,1,1,1,1,1,1,1,1,1,1,1,1,1,1,1,1,1,1],
    [1,0,0,0,0,0,0,0,0,1,1,0,0,0,0,0,0,0,0,1],
    [1,0,1,1,0,1,1,1,0,1,1,0,1,1,1,0,1,1,0,1],
    [1,0,1,1,0,1,1,1,0,0,0,0,1,1,1,0,1,1,0,1],
    [1,0,0,0,0,0,0,0,0,1,1,0,0,0,0,0,0,0,0,1],
    [1,0,1,1,0,1,0,1,1,1,1,1,1,0,1,0,1,1,0,1],
    [1,0,0,0,0,1,0,0,0,1,1,0,0,0,1,0,0,0,0,1],
    [1,1,1,1,0,1,1,1,0,0,0,0,1,1,1,0,1,1,1,1],
    [0,0,0,1,0,1,0,0,0,1,1,0,0,0,1,0,1,0,0,0],
    [1,1,1,1,0,1,0,1,1,1,1,1,1,0,1,0,1,1,1,1],
    [1,0,0,0,0,0,0,0,0,1,1,0,0,0,0,0,0,0,0,1],
    [1,0,1,1,0,1,1,1,0,0,0,0,1,1,1,0,1,1,0,1],
    [1,0,0,1,0,0,0,0,0,1,1,0,0,0,0,0,1,0,0,1],
    [1,0,0,0,0,1,1,1,0,1,1,0,1,1,1,0,0,0,0,1],
    [1,1,1,1,1,1,1,1,1,1,1,1,1,1,1,1,1,1,1,1]
],
      "vel_enemigos": 18,
      "estrellas": 3,
      "enemigos": 1,
      "powerups": 1,
      "entrada": [8, 8],
      "salida": [1, 1],
      "colores": {
        "pared": [60, 60, 60],
        "suelo": [220, 220, 220],
        "enemigo": [220, 50, 50]
      }
    }
  ]
}